T     PPP     SS       GGG     
      PPP     SSSS     GGOO     
     PPPP     SSSS     GGPO    
            SSSSS   CCC        
       CC     S     CCCP       
GGGGGGGGG           CCCPP      
GGOOOOGG      G     CCC        
  CCCPP     GG        SS       
   CCCCC     GGG      SSSSS    
      CCC     GGG     SSSGU    